2220002222
2222002002
0222122212
1222222202
2202202202
2002202222
0122211220
2222200201
2002222220
0012010222
Amazon
