2222222222
2100200012
2022222202
2021001202
2222220202
2020222222
2021001202
2022222202
2100020012
2222222222
Egypt