2222222010
2020102002
2220202022
0222222222
0002202202
1000222011
0022202201
2222210201
2200200200
2010222222
Alps
