2222222001
0012000022
0222222222
0000002222
2222201200
2100222220
2020000000
2022222222
2000210022
2222222000
China