2223102222
2303033332
2333223002
2222202222
0001222331
1232232222
2330230032
2333233133
2210222232
3222233222
Australia
