2222022322
3332323302
3012222222
2222302333
0202112320
1232002323
3332222222
0322332002
2320322332
2223333222
Antarctica
